##########
#        #
#   o    #
#     @O #
#        #
##########
