##########
#        #
#   o    #
#        #
#        #
##########
