############
#          #
#   o      #
#     @O   #
#          #
#          #
#          #
############
