############
#          #
#   o      #
#     @O   #
#          #
#    @     #
#       O  #
############
